NO ./textures/tiled_wall_poster_.png
SO ./textures/tiled_wall_mirror2.png
WE ./textures/tiled_wall_camera.png
EA ./textures/tiled_wall.png

F 138, 47, 47
C 163, 161, 155

1111111111111111111111111111111111111111
1000000000000000000000000000000000000001
1000000000000000000000000000000000000001
1000000000000000000000000000000000000001
1000111111111111111111011111111111110001
1000000000000000000001000000000000010001
1000101111111111111101011111111111010001
1000101000000000000101010000000001010001
1000101011111111110101010111111101010001
1000101010000000010101010100000101010001
1000101010111111010101010101110101010001
1000101010100001010101010100010101010001
1000101010101101010101010111010101010001
1000101010001001010101010001010101010001
1000101011111011010101011100010101010001
1000101000000010010101000111110101010001
1000101111111110110101110000000101010001
1000100000000000100100011111111101010001
1000111111111111101111000000000001010001
1000100000000000001S01111111111111010001
1000101111111111111001000000000000010001
1000101000000000001101011111111111110001
1000101011111111100101010000000000010001
1000101010000000110101010111111111010001
1000101010111110010101010100000001010001
1000101010100011010101010101111101010001
1000101010101001010101010101000101010001
1000101010101101010101010101010101010001
1000101010100101010101010100010101010001
1000101010110101010101010111110101010001
1000101010000101010101010000000101010001
1000101011111101010101011111111101010001
1000101000000001010101000000000001010001
1000101111111111010101111111111111010001
1000100000000000010100000000000000000001
1000111111111111110111111111111111110001
1000000000000000000000000000000000000001
1000000000000000000000000000000000000001
1000000000000000000000000000000000000001
1111111111111111111111111111111111111111

