NO ./textures/frame-png-texture-2938280_640.png
SO ./textures/cat-7635983_640.png
WE ./textures/blue-background-2369875_640.png
EA ./textures/blue-background-2369875_640.png                  

F 219, 188, 77
C 156, 130, 61

111111111111111111111111111111111111
100010000000000000000100000000000001
100010111111111111110101111111111101
100010100000000000010101000000000101
100010101111111111010101011111110101
100010101000000001010101010000010101
100010101011111101010101010111010101
100010101010000101010101010001010101
100010101010110101010101011101010101
100010101000100101010101000101010101
100010101111101101010101110001010101
100010100000001001010100011111010101
100010111111111011010111000000010101
100010000000000010010001111111110101
100011111111111110111100000000000101
1000100000000000001S0111111111111101
100010111111111111100100000000000001
100010100000000000110101111111111111
100010101111111110010101000000000001
100010101000000011010101011111111101
100010101011111001010101010000000101
100010101010001101010101010111110101
100010101010100101010101010100010101
100010101010110101010101010101010101
100010101010010101010101010001010101
100010101011010101010101011111010101
100010101000010101010101000000010101
100010101111110101010101111111110101
100010100000000101010100000000000101
100010111111111101010111111111111101
100010000000000001010000000000000001
100011111111111111010111111111111111
100000000000000000000000000000000001
100000000000000000000000000000000001
100000000000000000000000000000000001
111111111111111111111111111111111111

