NO ./textures/neon_wall.png             
SO ./textures/blue.png                  
WE ./textures/grey.png         
EA ./textures/light_blue.png                    

F 77,92,53           
C 163,208,230

11111111111111111111111111111111
10000000000000000100000000000001
10111111111111110101111111111101
10100000000000010101000000000101
10101111111111010101011111110101
10101000000001010101010000010101
10101011111101010101010111010101
10101010000101010101010001010101
10101010110101010101011101010101
10101000100101010101000101010101
10101111101101010101110001010101
10100000001001010100011111010101
10111111111011010111000000010101
10000000000010010001111111110101
11111111111110111100000000000101
100000000000001S0111111111111101
10111111111111100100000000000001
10100000000000110101111111111111
10101111111110010101000000000001
10101000000011010101011111111101
10101011111001010101010000000101
10101010001101010101010111110101
10101010100101010101010100010101
10101010110101010101010101010101
10101010010101010101010001010101
10101011010101010101011111010101
10101000010101010101000000010101
10101111110101010101111111110101
10100000000101010100000000000101
10111111111101010111111111111101
10000000000001010000000000000001
11111111111111111111111111111111
