NO ./textures/tiled_wall_poster_.png
SO ./textures/tiled_wall_mirror2.png
WE ./textures/tiled_wall_camera.png
EA ./textures/white-2484120_640.png
F 138, 47, 47
C 163, 161, 155

11111111111111111111111111
11000000000000000000000001
10000000000100001000010001
10001000000000000000000001
10000000011111111000000001
1000100001      1000010001
1000000001      1000000001
1000100001      1000010001
1000000001      1000000001
1000000001      1000010001
1000100001      1000000001
1000000001      1000010001
10001000011111111000000001
10000000000000000000010001
10001000100001000100W0000111111111111111111111111111111111111111111111111111111111111111111111111111111111111111
1000000000000000000000000000000000000000000000000000000000000000000000000000000000000000000000000000000000000001
1011111111111111111111111111111111111111111111111111111111111111111111111111111111111111111111111111111111111111
101
101
101
101
101
101
101
101
101
101
101
101
101
101
101
101
101
101
101
101
101
101
101
101
101
101
101
101
101
101
101
101
101
101
101
101
101
111

