
NO ./textures/neon_wall.png
SO ./textures/blue.png
WE ./textures/grey.png
EA ./textures/light_blue.png

F 77,92,53
C 163,208,230

11111111111111111111111111
10000000000000000000000001
10000000000000000000000001
10000000000000000000000001
10000000011111111000000001
1000000001      1000000001
1000000001      1000000001
1000000001      1000000001
1000000001      1000000001
1000000001      1000000001
1000000001      1000000001
1000000001      1000000001
10000000011111111000000001
10000000000000000000000001
10000000000000000000W00001
10000000000000000000000001
11111111111111111111111111
