NO ./textures/tiled_wall_poster_.png
SO ./textures/tiled_wall_mirror2.png
      
       WE              ./textures/tiled_wall_camera.png
                 
EA ./textures/tiled_wall.png

F 138 , 47,47                  
C 163,161,155

            111111111
            100000001
            1000000011111111111111111111
            1000000000000000000000000001
            1000000011111111111111111101                   1111111111111
            111101111                1011111111111         1000000000001
               101                   1000000000001         1000000000001     11111111
               101                   101000000010111111111 1000000000001 111110000001
               101                   10001010000010000000111000000000001110001000000111111111111111111111111111111111111111
            11110111                 10000000000000000000000000000000000000000000000000000000000000000000000000000000000001
            10000001                 10000000000010000000111000000000001110001000000111111111111111111111111111111111111001
            11000011              111100000000000111111111 1000000000001 111110000001                                  1101
            11000011            111000010000000101         1000000000001    111110111                                   101
            1000011           11100000000000000001         1111111110111111 100000001                                 11101
            11000011        1110001111111111111001              10000000001 100000001                                110001
            110000111     111000111           1001              10000000001 100000001                               1100001
            11000000111 111000111             1001              10000000001 100000001                              11000011
            1100000000111000111                10011            111111101111111101111                            111000011
            11000000000000011                   10011                10000000000001                           11110000011
            1100000000000011111                  1000111             10000000000001                        1111000001111
            1000000000000000001                   100001             11100000011111                     1111000001111
            100000000000000000111111111111111111111011001              10000001                        11000001111
            10001000010000100010000000000000000000001 1001             10000001                       111000111
        111110000000000000000010111111111111111111111111001            1000N001                      11000111
    11111000000000000000000000100000000000000000000000001001           11110111                    11000111
1111100000000000000000000000001111111111111111111111111011001             101                     110000011
100000000000000000000000000000000000000100001000100010001 1001         111101111                 110000011
100000000000000010000100001000111111010001000010001000101  1001        100000001                110000011
10000000000000000000000000000001    1011111111111111111111111011       100000001               110000011
10000000000000000000000000000001    1000000000000000000000001001       100000001              110000011
10000001111000000000000000000001    1010101000000010000111110001       111101111             110000011
10000001  1000000000000000000001    100001000001000000000000010111        101 11111   111   110000011
10000001  1000000100001000010001    1010010010000000000000111100011111111110111000111110111110000011
10000001111000000000000000000001    111000000000000000000000000000000000000000000000000000000000001
10000000000000000000000000000001    100000100000001111111111100000011111000001111111000001111111111
10000000000000000000000000000001    100000000000001         11111111   1111111     1111111
10000000000000000000000000000001    111111110000111
10000000000000000100001000010001 111 111 11100111
11110000010000010000100010010101111011011101101
   11110000000000000000000000000000000000000001
      11110000010000100010010101110111011101111
         11111000000000111111111 111 111 111
            11111011111
                111