NO ./textures/frame-png-texture-2938280_640.png
SO ./textures/cat-7635983_640.png
WE ./textures/blue-background-2369875_640.png
EA ./textures/banner-2383908_640.png

F 77,92,53
C 163,208,230

000000001111111111111111111111111
000000001000000000110000000000001
000000001011000001110000000000001
000000001001000000000000000001001
111111111011000001110000000000001
100000000011000001110111110111111
111101111111110111000000100010000
111101111111110111010100100010000
110000001101010111000000100010000
100000000000000011000000100010000
100000000000000011010100100010000
11000001110101011111011110N011100
111101110111010101011110100010000
111111110111111101111111111110000
