NO ./textures/north_wall_space_640.png
SO ./textures/south_wall_door_640.png
WE ./textures/west_wall_grate_640.png
EA ./textures/east_wall_alien_640.png

C 140,132,119
F 93,93,93

        1111111111111111111111111
        1000000000110000000000001
        1011000001110000000000001
        1001000000000000000001001
111111111011000001110000000000001
100000000011000001110111110111111
11110111111111011100000010001
11110111111111011101010010001
11000000110101011100000010001
10000000000000001100000010001
10000000000000001101010010001
11000001110101011101011110N01
11110111 1110101 101111110001
11111111 1111111 111111111111
