NO ./textures/tiled_wall_poster_.png
SO ./textures/tiled_wall_mirror2.png
WE ./textures/tiled_wall_camera.png
EA ./textures/tiled_wall.png
F 42, 130, 65
C 163, 161, 155
1111111111111111111111111
1000000000000000000000001
1000000000000000000000001
1000000000000000000000001
1000000000000000000000001
1000000000000000000000001
1000000000000000000000001
1000000000000000000000001
1000000000000000000000001
1000000000000000000000001
1000000000000000000000001
1000000000011100000000001
100000000001 100000000001
1000000000011100000000001
1000000000000000000000001
1000000000000000000000001
1000000000000000000000001
1000000000000000000000001
1000000000000000000000001
10000000000E0000000000001
1000000000000000000000001
1000000000000000000000001
1000000000000000000000001
1000000000000000000000001
1000000000000000000000001
1111111111111111111111111