NO ./textures/neon_wall.png
SO ./textures/blue.png
WE ./textures/grey.png
EA ./textures/light_blue.png

F 77,92,53
C 163,208,230

        1111110111111111111111111
        1000000000110000000000001
        1011000001110000000000001
        1001000000000000000001001
111111111011000001110000000000001
100000000011000001110111110111111
11110111111111011100000010001
11110111111111011101010010000
11000000110101011100000010000
10000000000000001100000010000
10000000000000001101010010000
11000001110101011111011110N0111
11110111 1110101 101111010001
11111111 1111111 111111111111
