NO ./textures/neon_wall.png
SO ./textures/blue.png
WE ./textures/grey.png
EA ./textures/light_blue.png

F 77,92,53
C 163,208,230

        1111111111111111111111111
        1000000000110000000000001
        1011000001110000000000001
        1001000000000000000001001
111111111011000001110000000000001
100000000000000000000000000011111
11110000000000011100000010001
11110000000000000001010010001
1100000011010101110000001000
10000000000000000000000010001
10000000000000001101010010001
11000001110101011111011110N0111
11110111 1110101 111111110001
11111111 1111111 111111111111
