NO                 ./textures/north.png                       
  C    225,30,0
            SO ./textures/south.png
WE ./textures/west.png
    EA ./textures/east.png

F 220,100,0


111111
100101
101001
110001  N
111111
